x-x---x-x-x-x
xx-xx-xxx---x
xx--x----x--x
----xxx------
-xx----x-x-xx
---x-xxx-x--x
x-x--xxxx-xx-
x-x-x---xxxxx
